11111111111
10000000001
1000000E001
11101P00001
100C1000001
11111111111