11111111111
10000P00001
1000000E001
11101000001
100C1000001
11111111111