111111111
100000001
101011101
1000000P1
101111101
1000C00E1
111111111
