1111111111111111111111111111111
1P00000000C00000000000000000E11
1011111011111101111111101111101
1000001010000101000000000000001
1011101010110101011111101111101
1000101010000101000000000000C01
1110101011101101110111101110101
1C00101000001000001000000000001
1111010111010111101110111011101
1000010001010000001000100000001
1011111111011111111011101111101
1000000000000000000000000000C01
1111011111111110111111111101111
1000000000000000000000000000001
1000000000000000000000000000C01
1111111111111111111111111111111
